############1.main(메인)####################################
main=mypkg.common.MainController
about=mypkg.common.AboutController
############2.member(회원)##################################
meLogin=mypkg.member.MemberLoginController
meLogout=mypkg.member.MemberLogoutController
meInsert=mypkg.member.MemberInsertController
meIdCheck=mypkg.member.MemberIdCheckController
meList=mypkg.member.MemberListController
meSort=mypkg.member.MemberSortController
meDetailView=mypkg.member.MemberDetailViewController
meUpdate=mypkg.member.MemberUpdateController
meDelete=mypkg.member.MemberDeleteController
meIdSearch=mypkg.member.MemberIdSearchController
mePwSearch=mypkg.member.MemberPwsearchController
mePwChange=mypkg.member.MemberPwChangeController
############3.product(상품)###################################
prList=mypkg.product.ProductListController
prDetail=mypkg.product.ProductDetailController
prPrice=mypkg.product.ProductPriceController
prInsert=mypkg.product.ProductInsertController
prDelete=mypkg.product.ProductDeleteController
prUpdate=mypkg.product.ProductUpdateController
prFee=mypkg.product.ProductFeeController
prFac=mypkg.product.ProductFacController
############4.reservation(결제 전 예약)##########################
reInsert=mypkg.reservation.ReservationInsertController
reDelete=mypkg.reservation.ReservationDeleteController
########5.order(결제내역)########################################
orList=mypkg.order.OrderListController
#orDelete=mypkg.order.OrderDeleteController
#orUpdate=mypkg.order.OrderUpdateController
########6.notify(공지사항)######################################
noList=mypkg.notify.NotifyListController
noInsert=mypkg.notify.NotifyInsertController
noDetailView=mypkg.notify.NotifyDetailViewController
noDelete=mypkg.notify.NotifyDeleteController
noUpdate=mypkg.notify.NotifyUpdateController
############7.QnA###########################################
#QAsend=mypkg.qna.QnasendController